drawbacks (n): nhược điểm
proficient (adj): thành thạo
integrate (v): tích hợp
take into account (phrase): xem xét
it goes without saying (phrase): không cần phải nói
make the most of (phrase): tận dụng tối đa
bear in mind (phrase): ghi nhớ
convincing arguments (phrase): lập luận thuyết phục
comprehensive (adj): toàn diện
perseverance (noun): sự kiên trì
persists in (phrase): kiên trì theo đuổi
well-rounded (adjective): toàn diện
virtue (noun): đức tính
garnered (verb): thu được, giành được
foundation (noun): nền tảng
critical thinking (noun): tư duy phản biện
pedagogy (noun): phương pháp giảng dạy
to keep up with (phrase): theo kịp với
syllabus (noun): giáo trình
curriculum (noun): chương trình học
extracurricular (adjective): ngoại khóa
broaden one's horizons (phrase): mở mang tầm nhìn của bạn
facilitate (verb): làm cho việc học dễ dàng hoặc có thể đạt được
Collaborative learning (noun): học tập hợp tác
Self-directed learning (noun): tự học
Blended learning (noun): học tập kết hợp
Holistic education (noun): giáo dục toàn diện
Experiential learning (noun): học qua trải nghiệm
Scaffolding (noun): giảng dạy theo cách từng step 
Lifelong learning (noun): học tập suốt đời
Paradigm Shift (noun): Sự thay đổi lớn về cách nhìn nhận hoặc cách làm việc
In the long run (phrase): Về lâu dài
absorb (verb): hấp thụ
lecture (noun): bài giảng
fully capitalize on (verb): tận dụng tối đa
precious (adj): quý giá
aid in (phrasal verb): hỗ trợ, giúp đỡ
mentor (noun): người cố vấn
literacy (noun): sự biết đọc, biết viết
