off the beaten path (idiom): Nơi chưa được khám phá nhiều, ít người biết đến
itinerary (noun): lịch trình
excursion (noun): Chuyến tham quan
expedition (noun): Cuộc thám hiểm
Antarctica (noun): Nam cực
lush (adjective): tươi tốt, xum xuê
insatiable (adj): không thể thỏa mãn
intriguing (adj): thú vị
wanderlust (noun): khát khao mãnh liệt để đi du lịch
travel extensively: travel a lot or over a large area
embark (verb): lên tàu, bắt đầu chuyến đi
sojourn (noun): sự tạm trú
voyage (noun): chuyến đi xa
trek (noun): chuyến đi bộ xa
globetrotter (noun): người đi du lịch khắp thế giới
jaunt (noun): chuyến du ngoạn ngắn
brief outing (noun): chuyến đi ngắn
jaunt (noun): chuyến du ngoạn ngắn
brief outing (noun): chuyến đi ngắn
scenic (adjective): có nhiều cảnh đẹp
layover (noun): thời gian nghỉ giữa các chặng bay
accommodation (noun): chỗ ở
backpacking (noun): Du lịch bụi
backpacker (noun): Khách du lịch bụi
backpack (noun): ba lô
backpacking (verb): đi du lịch bụi
hitchhiking (noun): Đi nhờ xe
souvenir (noun): quà lưu niệm
passport (noun): hộ chiếu
adventure (noun): cuộc phiêu lưu
jet lag (noun): mệt mỏi do lệch múi giờ
red-eye flight (noun): chuyến bay đêm muộn
stopover (noun): điểm dừng chân
detour (noun): đường vòng
retreat (noun): khu nghỉ dưỡng
Nomadic (adjective): Du mục
excursionist (noun): khách du lịch trong ngày
voyager (noun): Nhà du hành
Glamping (noun): Cắm trại sang trọng
glamping (noun): cắm trại sang trọng
retrospect (verb): hồi tưởng lại, nhìn về quá khứ
serendipity (noun): sự tình cờ mang lại kết quả tốt đẹp
reminisce (verb): hồi tưởng lại, nhớ về quá khứ
transit (noun): quá cảnh
traverse (verb): đi qua, vượt qua
wander (verb): đi lang thang
peripatetic (adjective): đi khắp nơi
serene (adj): thanh bình, yên tĩnh
expansive (adjective): rộng lớn, bao la
breathtaking (adjective): hấp dẫn, ngoạn mục
unspoiled (adjective): chưa bị phá hủy
picturesque (adjective): đẹp như tranh vẽ
coastline (noun): bờ biển
rejuvenate (verb): làm tươi mới, hồi sinh
serene (adjective): thanh bình, yên tĩnh
expat (noun): người sinh sống ở nước ngoài
expatriate (noun): người sống xa quê hương
cruise (noun): chuyến du thuyền
destination (noun): điểm đến
scenic (adj): có cảnh đẹp, nên thơ
touristy (adjective): đông khách du lịch
resort (noun): khu nghỉ dưỡng
escapade (noun): cuộc phiêu lưu mạo hiểm
explore (verb): khám phá
globetrot (verb): đi du lịch khắp thế giới
adventurous (adjective): thích phiêu lưu
navigate (verb): điều hướng
journey (noun): Hành trình
scenery (noun): phong cảnh
locale (noun): địa phương, nơi, chốn
round trip (noun): chuyến đi và về
overland (adjective): Đi qua đất liền
inn (noun): quán trọ, nhà khách
vagabond (noun): kẻ lang thang, người đi lang thang
nomad (noun): người sống du mục
peripetic (adjective): đi nhiều nơi, phiêu bồng
nomadic (adjective): đi khắp nơi để tìm kiếm thức ăn hoặc nguồn sống
peregrination (noun): cuộc hành trình
unexplored (adjective): chưa được khám phá
wanderer (noun): Người lang thang
pilgrimage (noun): cuộc hành hương
tripper (noun): Người đi du lịch ngắn hạn
